1111111111111111111111111111111111111111111111111111111111111111111111111111111111111111111111111111
1000000000000000000000000000000000000000000001000000100000000000000000000000000000000000000000000001
1000000000000000000000000000000000000000000001000000100000000000000000000000000000000000000000000001
1000000000000000000000000000000000000000000001000000100000000000000000000000000000000000000000000001
1000000000000000000000000000000000000000000001000000100000000000000000000000000000000000000000000001
1000000000000000000000000000000000000000000001000000100000000000000000000000000000000000000000000001
1000000000000000000000000000000000000000000001000000100000000000000000000000000000000000000000000001
1000000000000000000000000000000000000000000001000000100000000000000000000000000000000000000000000001
1000000000000000000000000000000000000000000001000000100000000000000000000000000000000000000000000001
1000000000000000000000000000000000000000000001000111100000000000000000000000000000000000000000000001
1000000000000001111111110000000000000000000001000100000000000000000000000000000000000000000000000001
1000000000000001000000011000000000000000000001000100000000000000000000000000000000000000000000000001
1000000000000001000000001000000000001111111111000100000000000000000000000000000000000000000000000001
1000000000000001000000001000000000011000000000000100000000000000000000000000000000000000000000000001
1000000000000001000000001000000000010000000000000100000000000000000000000000000000000000000000000001
1000000000000001000111101000000000110000000000000100000000000000000000000000000000000000000000000001
1000000000000001001000101000000000100000000000000100000000000000000000000000000000000000000000000001
1000000000000001001000101000000000100000000000000100000000000000000000000000000000000000000000000001
1000000000011110000111101111111100100011111111111100000000000000000000000000000000000000000000000001
1000000000010000000000000000000100100010000000000000000000000000000000000000000000000000000000000001
1000000000010000000000000000000100100010000000000000000000000000000000000000000000000000000000000001
1000000000010000000000000000000100100010000000000000000000000000000000000000000000000000000000000001
1000011111110111111111110011100100100010000000000000000000000000000000000000000000000000000000000001
1000001000000100000000010010000100100011001111100000000000000000000000000000000000000000000000000001
1000001000000100000000010010100100110111110000010000000000000000000000000000000000000000000000000001
1000001001110111111111110011100111110111000000010000000000000000000000000000000000000000000000000001
1000001001010000000000000000000111000000000000010100000000000000000000000000000000000000000000000001
1000001001010000000000000000000111000000000000000100000000000000000000000000000000000000000000000001
1000001001010000000000000000000111000001110000000100000000000000000000000000000000000000000000000001
1000001001011111000111100111111111000001111100000100000000000000000000000000000000000000000000000001
1000010001000001001000100100000001000000111110000100000000000000000000000000000000000000000000000001
1000010001000001001000100101111110000000111110000111111000000000000000000000000000000000000000000001
1000010001000001001000100111000000000000000000000100001000000000000000000000000000000000000000000001
1000010001000001001000100001000000000000000000000100001000000000000000000000000000000000000000000001
1000010001000001001000100000000000011100000001111100001000000000000000000000000000000000000000000001
1000010001000001001000100000000000011100000001000000111000000000000000000000000000000000000000000001
1000010001000001001100100000000000010100000001000000001000000000000000000000000000000000000000000001
1000010001111111000111000001000000010100000000000000001000000000000000000000000000000000000000000001
1011110000000000000000000111000000000000000000000000011000000000000000000000000000000000000000000001
1010000000000000000000000111000000000000011000000000100000000000000000000000000000000000000000000001
1010000000000000000000000111111100000000101111000000100000000000000000000000000000000000000000000001
1010000111111111111111111111111111000001111110000000100000000000000000000000000000000000000000000001
1010001100000000000000001000011111000001111000000000100000000000000000000000000000000000000000000001
1010000111111111111111110000011111000001111000000000100000000000000000000000000000000000000000000001
1010000000000000100100000000001111000001100000000000011000000000000000000000000000000000000000000001
1010000000000000100100000000000011011101100000000000001000000000000000000000000000000000000000000001
1010000000000000100100000000000011011000000000000000001100000000000000000000000000000000000000000001
1010000000000000100100001111000011011000000000000000111111000000000000000000000000000000000000000001
1010000000000000100100001001000011011000000000000000100001000000000000000000000000000000000000000001
1010000000000000100100001001000011011000000100000000100001000000000000000000000000000000000000000001
1010000000000000100100001001000010011000000111111111101001000000000000000000000000000000000000000001
1010000000000000100100001001100000011000000000000000001001000000000000000000000000000000000000000001
1010000000000000100100001001100000011000000000000000001001000000000000000000000000000000000000000001
1010000000000000100100001001100000011000000000000000001001000000000000000000000000000000000000000001
1010000000000000100100001001100000011001111000011110001001111111110000000000000000000000000000000001
1010000000000000100100001001100000011001000000010010001000000001000000000000000000000000000000000001
1010000000000000100100001111100000011001001000010010001100000001000000000000000000000000000000000001
1010000000000000100100000000000000011001001000010010001111110111000000000000000000000000000000000001
1010000000000000100100000000000000011001111000010010001100010111000000000000000000000000000000000001
1010000000000000100100000000000000011000000000001110000111110011000000000000000000000000000000000001
1011111111111111111111111111111111111000000000000000000000000000000000000000000000000000000000000001
1000000000000000000000000000000000001000000000000000000001110011000000000000000000000000000000000001
1000000000000000000000000000000000001000000000000000000001010101010000000000000000000000000000000001
1000000000000000000000000000000000001111111111001111111000010101010000000000000000000000000000000001
1000000000000000000000000000000000000000000001001111000001110111010000000000000000000000000000000001
1000000000000000000000000000000000000000000001000000000011000000010000000000000000000000000000000001
1000000000000000000000000000000000000000000001000000001110000000010000000000000000000000000000000001
1000000000000000000000000000000000000000000001011111000000000000010000000000000000000000000000000001
1000000000000000000000000000000000000000000001010001000000000000010000000000000000000000000000000001
1000000000000000000000000000000000000000000001011111111000000000010000000000000000000000000000000001
1000000000000000000000000000000000000000000001000000000000000000010000000000000000000000000000000001
1000000000000000000000000000000000000000000001000000000000000000010000000000000000000000000000000001
1000000000000000000000000000000000000000000001011111111000000000010000000000000000000000000000000001
1000000000000000000000000000000000000000000001000000000000000000010000000000000000000000000000000001
1000000000000000000000000000000000000000000001000000000000000000010000000000000000000000000000000001
1000000000000000000000000000000000000000000001111111111000000000010000000000000000000000000000000001
1000000000000000000000000000000000000000000000000000001000000000010000000000000000000000000000000001
1000000000000000000000000000000000000000000000000000000100000000010000000000000000000000000000000001
1000000000000000000000000000000000000000000000000000000111111111110000000000000000000000000000000001
1000000000000000000000000000000000000000000000000000000000000000000000000000000000000000000000000001
1000000000000000000000000000000000000000000000000000000000000000000000000000000000000000000000000001
1000000000000000000000000000000000000000000000000000000000000000000000000000000000000000000000000001
1000000000000000000000000000000000000000000000000000000000000000000000000000000000000000000000000001
1000000000000000000000000000000000000000000000000000000000000000000000000000000000000000000000000001
1000000000000000000000000000000000000000000000000000000000000000000000000000000000000000000000000001
1000000000000000000000000000000000000000000000000000000000000000000000000000000000000000000000000001
1111111111111111111111111111111111111111111111111111111111111111111111111111111111111111111111111111
